,id,indent,purchase,cummulative_indnet,cummulative_purchase,ActiveIndent,likely_to_purchased,N_Column,Failure
0,1,40,0.0,40,0.0,0,0,0,0
1,2,300,126.0199966430664,340,126.0199966430664,0,0,0,0
2,3,40,0.0,380,126.0199966430664,0,0,0,0
3,4,200,0.0,580,126.0199966430664,0,0,0,0
4,5,180,0.0,760,126.0199966430664,0,0,0,0
5,6,200,0.0,960,126.0199966430664,0,0,0,0
6,7,180,0.0,1140,126.0199966430664,0,0,0,0
7,8,160,0.0,1300,126.0199966430664,0,0,0,0
8,9,80,0.0,1380,126.0199966430664,0,0,0,0
9,10,200,0.0,1580,126.0199966430664,0,0,0,0
10,11,160,0.0,1740,126.0199966430664,0,0,0,0
11,12,100,0.0,1840,126.0199966430664,0,0,0,0
12,13,200,0.0,2040,126.0199966430664,0,0,0,0
13,14,200,0.0,2240,126.0199966430664,0,0,0,0
14,15,140,0.0,2380,126.0199966430664,0,0,0,0
15,16,200,0.0,2580,126.0199966430664,0,0,0,0
16,17,200,0.0,2780,126.0199966430664,0,0,0,0
17,18,20,0.0,2800,126.0199966430664,0,0,0,0
18,19,100,0.0,2900,126.0199966430664,0,0,0,0
19,20,80,0.0,2980,126.0199966430664,0,0,0,0
20,21,140,0.0,3120,126.0199966430664,0,0,0,0
21,22,200,0.0,3320,126.0199966430664,0,0,0,0
22,23,180,0.0,3500,126.0199966430664,0,0,0,0
23,24,120,0.0,3620,126.0199966430664,0,0,0,0
24,25,60,0.0,3680,126.0199966430664,0,0,0,0
25,26,200,0.0,3880,126.0199966430664,0,0,0,0
26,27,180,0.0,4060,126.0199966430664,0,0,0,0
27,28,60,0.0,4120,126.0199966430664,0,0,0,0
28,29,180,0.0,4300,126.0199966430664,0,0,0,0
29,30,140,0.0,4440,126.0199966430664,0,0,0,0
30,31,200,0.0,4640,126.0199966430664,0,0,0,0
31,32,360,0.0,5000,126.0199966430664,0,0,0,0
32,33,320,0.0,5320,126.0199966430664,0,0,0,0
33,34,380,0.0,5700,126.0199966430664,0,0,0,0
34,35,280,0.0,5980,126.0199966430664,0,0,0,0
35,36,360,0.0,6340,126.0199966430664,0,0,0,0
36,37,200,0.0,6540,126.0199966430664,0,0,0,0
37,38,300,0.0,6840,126.0199966430664,0,0,0,0
38,39,180,0.0,7020,126.0199966430664,0,0,0,0
39,40,380,0.0,7400,126.0199966430664,0,0,0,0
40,41,360,0.0,7760,126.0199966430664,0,0,0,0
41,42,380,0.0,8140,126.0199966430664,0,0,0,0
42,43,280,0.0,8420,126.0199966430664,0,0,0,0
43,44,360,0.0,8780,126.0199966430664,0,0,0,0
44,45,280,0.0,9060,126.0199966430664,0,0,0,0
45,46,120,0.0,9180,126.0199966430664,0,0,0,0
46,47,200,0.0,9380,126.0199966430664,0,0,0,0
47,48,200,0.0,9580,126.0199966430664,0,0,0,0
48,49,340,0.0,9920,126.0199966430664,0,0,0,0
49,50,400,0.0,10320,126.0199966430664,0,0,0,0
50,51,380,0.0,10700,126.0199966430664,0,0,0,0
51,52,400,0.0,11100,126.0199966430664,0,0,0,0
52,53,200,0.0,11300,126.0199966430664,0,0,0,0
53,54,400,0.0,11700,126.0199966430664,0,0,0,0
54,55,280,0.0,11980,126.0199966430664,0,0,0,0
55,56,180,0.0,12160,126.0199966430664,0,0,0,0
56,57,400,0.0,12560,126.0199966430664,0,0,0,0
57,58,380,0.0,12940,126.0199966430664,0,0,0,0
58,59,380,0.0,13320,126.0199966430664,0,0,0,0
59,60,160,0.0,13480,126.0199966430664,0,0,0,0
60,61,200,0.0,13680,126.0199966430664,0,0,0,0
61,62,200,68.30999755859375,13880,194.32999420166016,0,0,0,0
62,63,200,0.0,14080,194.32999420166016,0,0,0,0
63,64,200,0.0,14280,194.32999420166016,0,0,0,0
64,65,200,20.0,14480,214.32999420166016,0,0,0,0
65,66,220,45.540000915527344,14700,259.8699951171875,0,0,0,0
66,67,180,0.0,14880,259.8699951171875,0,0,0,0
67,68,200,0.0,15080,259.8699951171875,0,0,0,0
68,69,200,0.0,15280,259.8699951171875,0,0,0,0
69,70,200,0.0,15480,259.8699951171875,0,0,0,0
70,71,200,0.0,15680,259.8699951171875,0,0,0,0
71,72,160,0.0,15840,259.8699951171875,0,0,0,0
72,73,200,0.0,16040,259.8699951171875,0,0,0,0
73,74,200,0.0,16240,259.8699951171875,0,0,0,0
74,75,160,0.0,16400,259.8699951171875,0,0,0,0
75,76,200,0.0,16600,259.8699951171875,0,0,0,0
76,77,180,0.0,16780,259.8699951171875,0,0,0,0
77,78,180,0.0,16960,259.8699951171875,0,0,0,0
78,79,200,0.0,17160,259.8699951171875,0,0,0,0
79,80,200,0.0,17360,259.8699951171875,0,0,0,0
80,81,200,0.0,17560,259.8699951171875,0,0,0,0
81,82,200,0.0,17760,259.8699951171875,0,0,0,0
82,83,180,0.0,17940,259.8699951171875,0,0,0,0
83,84,180,0.0,18120,259.8699951171875,0,0,0,0
84,85,180,0.0,18300,259.8699951171875,0,0,0,0
85,86,200,0.0,18500,259.8699951171875,0,0,0,0
86,87,200,0.0,18700,259.8699951171875,0,0,0,0
87,88,200,0.0,18900,259.8699951171875,0,0,0,0
88,89,200,0.0,19100,259.8699951171875,0,0,0,0
89,90,200,0.0,19300,259.8699951171875,0,0,0,0
90,91,300,0.0,19600,259.8699951171875,0,0,0,0
91,92,300,0.0,19900,259.8699951171875,0,0,0,0
92,93,100,0.0,20000,259.8699951171875,0,0,0,0
93,94,120,0.0,20120,259.8699951171875,0,0,0,0
94,95,200,0.0,20320,259.8699951171875,0,0,0,0
95,96,260,0.0,20580,259.8699951171875,0,0,0,0
96,97,300,0.0,20880,259.8699951171875,0,0,0,0
97,98,280,0.0,21160,259.8699951171875,0,0,0,0
98,99,120,0.0,21280,259.8699951171875,0,0,0,0
99,100,280,0.0,21560,259.8699951171875,0,0,0,0
100,101,200,0.0,21760,259.8699951171875,0,0,0,0
101,102,200,0.0,21960,259.8699951171875,0,0,0,0
102,103,280,0.0,22240,259.8699951171875,0,0,0,0
103,104,200,0.0,22440,259.8699951171875,0,0,0,0
104,105,180,0.0,22620,259.8699951171875,0,0,0,0
105,106,180,0.0,22800,259.8699951171875,0,0,0,0
106,107,100,0.0,22900,259.8699951171875,0,0,0,0
107,108,80,0.0,22980,259.8699951171875,0,0,0,0
108,109,80,0.0,23060,259.8699951171875,0,0,0,0
109,110,160,0.0,23220,259.8699951171875,0,0,0,0
110,111,200,0.0,23420,259.8699951171875,0,0,0,0
111,112,200,0.0,23620,259.8699951171875,0,0,0,0
112,113,180,0.0,23800,259.8699951171875,0,0,0,0
113,114,460,716.2999877929688,24260,976.1699829101562,0,0,0,0
114,115,360,409.9100036621094,24620,1386.0799865722656,0,0,0,0
115,116,360,0.0,24980,1386.0799865722656,0,0,0,0
116,117,380,0.0,25360,1386.0799865722656,0,0,0,0
117,118,400,0.0,25760,1386.0799865722656,0,0,0,0
118,119,380,0.0,26140,1386.0799865722656,0,0,0,0
119,120,460,525.6900024414062,26600,1911.7699890136719,0,0,0,0
120,121,200,432.6300048828125,26800,2344.3999938964844,0,0,0,0
121,122,480,842.489990234375,27280,3186.8899841308594,0,0,0,0
122,123,380,134.13999938964844,27660,3321.029983520508,0,0,0,0
123,124,400,0.0,28060,3321.029983520508,0,0,0,0
124,125,400,500.6400146484375,28460,3821.6699981689453,0,0,0,0
125,126,460,751.4099731445312,28920,4573.079971313477,0,0,0,0
126,127,360,273.239990234375,29280,4846.319961547852,0,0,0,0
127,128,420,0.0,29700,4846.319961547852,0,0,0,0
128,129,380,728.5900268554688,30080,5574.90998840332,0,0,0,0
129,130,360,113.8499984741211,30440,5688.759986877441,0,0,0,0
130,131,460,399.8800048828125,30900,6088.639991760254,0,0,0,0
131,132,500,0.0,31400,6088.639991760254,0,0,0,0
132,133,380,0.0,31780,6088.639991760254,0,0,0,0
133,134,480,45.540000915527344,32260,6134.179992675781,0,0,0,0
134,135,160,0.0,32420,6134.179992675781,0,0,0,0
135,136,460,0.0,32880,6134.179992675781,0,0,0,0
136,137,480,227.6999969482422,33360,6361.879989624023,0,0,0,0
137,138,360,227.6999969482422,33720,6589.579986572266,0,0,0,0
138,139,440,546.47998046875,34160,7136.059967041016,0,0,0,0
139,140,480,0.0,34640,7136.059967041016,0,0,0,0
140,141,500,637.4600219726562,35140,7773.519989013672,0,0,0,0
141,142,300,0.0,35440,7773.519989013672,0,0,0,0
142,143,300,500.94000244140625,35740,8274.459991455078,0,0,0,0
143,144,300,408.3699951171875,36040,8682.829986572266,0,0,0,0
144,145,300,364.32000732421875,36340,9047.149993896484,0,0,0,0
145,146,360,614.7899780273438,36700,9661.939971923828,0,0,0,0
146,147,280,409.8599853515625,36980,10071.79995727539,0,0,0,0
147,148,340,341.54998779296875,37320,10413.34994506836,0,0,0,0
148,149,240,0.0,37560,10413.34994506836,0,0,0,0
149,150,400,182.16000366210938,37960,10595.509948730469,0,0,0,0
150,151,400,273.19000244140625,38360,10868.699951171875,0,0,0,0
151,152,280,387.0899963378906,38640,11255.789947509766,0,0,0,0
152,153,400,0.0,39040,11255.789947509766,0,0,0,0
153,154,240,337.0,39280,11592.789947509766,0,0,0,0
154,155,280,407.0899963378906,39560,11999.879943847656,0,0,0,0
155,156,300,364.32000732421875,39860,12364.199951171875,0,0,0,0
156,157,280,136.6199951171875,40140,12500.819946289062,0,0,0,0
157,158,380,296.010009765625,40520,12796.829956054688,0,0,0,0
158,159,300,0.0,40820,12796.829956054688,0,0,0,0
159,160,280,159.38999938964844,41100,12956.219955444336,0,0,0,0
160,161,280,409.8599853515625,41380,13366.079940795898,0,0,0,0
161,162,260,0.0,41640,13366.079940795898,0,0,0,0
162,163,400,0.0,42040,13366.079940795898,0,0,0,0
163,164,300,387.0400085449219,42340,13753.11994934082,0,0,0,0
164,165,400,0.0,42740,13753.11994934082,0,0,0,0
165,166,300,0.0,43040,13753.11994934082,0,0,0,0
166,167,240,0.0,43280,13753.11994934082,0,0,0,0
167,168,280,387.0899963378906,43560,14140.209945678711,0,0,0,0
168,169,400,295.6099853515625,43960,14435.819931030273,0,0,0,0
169,170,280,227.6999969482422,44240,14663.519927978516,0,0,0,0
170,171,380,205.17999267578125,44620,14868.699920654297,0,0,0,0
171,172,300,0.0,44920,14868.699920654297,0,0,0,0
172,173,300,455.20001220703125,45220,15323.899932861328,0,0,0,0
173,174,280,273.2900085449219,45500,15597.18994140625,0,0,0,0
174,175,100,0.0,45600,15597.18994140625,0,0,0,0
175,176,180,0.0,45780,15597.18994140625,0,0,0,0
176,177,300,0.0,46080,15597.18994140625,0,0,0,0
177,178,260,0.0,46340,15597.18994140625,0,0,0,0
178,179,260,0.0,46600,15597.18994140625,0,0,0,0
179,180,300,0.0,46900,15597.18994140625,0,0,0,0
180,181,60,0.0,46960,15597.18994140625,0,0,0,0
181,182,280,0.0,47240,15597.18994140625,0,0,0,0
182,183,200,0.0,47440,15597.18994140625,0,0,0,0
183,184,200,0.0,47640,15597.18994140625,0,0,0,0
184,185,280,0.0,47920,15597.18994140625,0,0,0,0
185,186,200,0.0,48120,15597.18994140625,0,0,0,0
186,187,180,0.0,48300,15597.18994140625,0,0,0,0
187,188,160,0.0,48460,15597.18994140625,0,0,0,0
188,189,100,0.0,48560,15597.18994140625,0,0,0,0
189,190,100,0.0,48660,15597.18994140625,0,0,0,0
190,191,100,0.0,48760,15597.18994140625,0,0,0,0
191,192,200,0.0,48960,15597.18994140625,0,0,0,0
192,193,200,0.0,49160,15597.18994140625,0,0,0,0
193,194,200,0.0,49360,15597.18994140625,0,0,0,0
194,195,200,250.47000122070312,49560,15847.659942626953,0,0,0,0
195,196,9120,1472.1300048828125,58680,17319.789947509766,0,0,0,0
196,197,13300,1909.8499755859375,71980,19229.639923095703,0,0,0,0
197,198,360,0.0,72340,19229.639923095703,0,0,0,0
198,199,260,614.7899780273438,72600,19844.429901123047,0,0,0,0
199,200,300,159.24000549316406,72900,20003.66990661621,0,0,0,0
200,201,300,705.8699951171875,73200,20709.5399017334,0,0,0,0
201,202,300,796.9500122070312,73500,21506.48991394043,0,0,0,0
202,203,200,68.30999755859375,73700,21574.799911499023,0,0,0,0
203,204,260,0.0,73960,21574.799911499023,0,0,0,0
204,205,380,296.010009765625,74340,21870.80992126465,0,0,0,0
205,206,360,0.0,74700,21870.80992126465,0,0,0,0
206,207,280,819.3200073242188,74980,22690.129928588867,0,0,0,0
207,208,300,1047.4200439453125,75280,23737.54997253418,0,0,0,0
208,209,280,0.0,75560,23737.54997253418,0,0,0,0
209,210,340,227.6999969482422,75900,23965.249969482422,0,0,0,0
210,211,260,523.7100219726562,76160,24488.959991455078,0,0,0,0
211,212,300,500.8900146484375,76460,24989.850006103516,0,0,0,0
212,213,200,113.8499984741211,76660,25103.700004577637,0,0,0,0
213,214,200,614.7899780273438,76860,25718.48998260498,0,0,0,0
214,215,280,0.0,77140,25718.48998260498,0,0,0,0
215,216,300,45.540000915527344,77440,25764.029983520508,0,0,0,0
216,217,300,500.94000244140625,77740,26264.969985961914,0,0,0,0
217,218,400,546.47998046875,78140,26811.449966430664,0,0,0,0
218,219,320,444.8999938964844,78460,27256.34996032715,0,0,0,0
219,220,280,956.3900146484375,78740,28212.739974975586,0,0,0,0
220,221,380,774.1799926757812,79120,28986.919967651367,0,0,0,0
221,222,160,475.5899963378906,79280,29462.509963989258,0,0,0,0
222,223,280,522.1300048828125,79560,29984.63996887207,0,0,0,0
223,224,400,956.3400268554688,79960,30940.97999572754,0,0,0,0
224,225,300,182.16000366210938,80260,31123.13999938965,0,0,0,0
225,226,180,432.5799865722656,80440,31555.719985961914,0,0,0,0
226,227,200,0.0,80640,31555.719985961914,0,0,0,0
227,228,280,0.0,80920,31555.719985961914,0,0,0,0
228,229,200,273.239990234375,81120,31828.95997619629,0,0,0,0
229,230,280,227.6999969482422,81400,32056.65997314453,0,0,0,0
230,231,200,273.0400085449219,81600,32329.699981689453,0,0,0,0
231,232,200,0.0,81800,32329.699981689453,0,0,0,0
232,233,180,409.8599853515625,81980,32739.559967041016,0,0,0,0
233,234,200,273.239990234375,82180,33012.79995727539,0,0,0,0
234,235,200,296.010009765625,82380,33308.809967041016,0,0,0,0
235,236,160,204.92999267578125,82540,33513.7399597168,0,0,0,0
236,237,200,660.3300170898438,82740,34174.06997680664,0,0,0,0
237,238,200,0.0,82940,34174.06997680664,0,0,0,0
238,239,180,0.0,83120,34174.06997680664,0,0,0,0
239,240,200,0.0,83320,34174.06997680664,0,0,0,0
240,241,200,91.08000183105469,83520,34265.149978637695,0,0,0,0
241,242,200,0.0,83720,34265.149978637695,0,0,0,0
242,243,200,455.29998779296875,83920,34720.449966430664,0,0,0,0
243,244,180,477.7699890136719,84100,35198.219955444336,0,0,0,0
244,245,180,0.0,84280,35198.219955444336,0,0,0,0
245,246,200,0.0,84480,35198.219955444336,0,0,0,0
246,247,180,634.5900268554688,84660,35832.809982299805,0,0,0,0
247,248,200,45.540000915527344,84860,35878.34998321533,0,0,0,0
248,249,160,796.9500122070312,85020,36675.29999542236,0,0,0,0
249,250,200,627.6099853515625,85220,37302.909980773926,0,0,0,0
250,251,200,0.0,85420,37302.909980773926,0,0,0,0
251,252,180,0.0,85600,37302.909980773926,0,0,0,0
252,253,200,113.80000305175781,85800,37416.70998382568,0,0,0,0
253,254,200,500.94000244140625,86000,37917.64998626709,0,0,0,0
254,255,280,409.8599853515625,86280,38327.50997161865,0,0,0,0
255,256,180,0.0,86460,38327.50997161865,0,0,0,0
256,257,300,455.1499938964844,86760,38782.65996551514,0,0,0,0
257,258,300,293.0400085449219,87060,39075.69997406006,0,0,0,0
258,259,100,227.6999969482422,87160,39303.3999710083,0,0,0,0
259,260,280,0.0,87440,39303.3999710083,0,0,0,0
260,261,280,204.92999267578125,87720,39508.32996368408,0,0,0,0
261,262,300,728.6400146484375,88020,40236.96997833252,0,0,0,0
262,263,300,159.38999938964844,88320,40396.35997772217,0,0,0,0
263,264,300,773.1900024414062,88620,41169.549980163574,0,0,0,0
264,265,200,455.3999938964844,88820,41624.94997406006,0,0,0,0
265,266,200,136.6199951171875,89020,41761.569969177246,0,0,0,0
266,267,200,478.1700134277344,89220,42239.73998260498,0,0,0,0
267,268,200,455.3999938964844,89420,42695.139976501465,0,0,0,0
268,269,180,478.1700134277344,89600,43173.3099899292,0,0,0,0
269,270,200,478.1700134277344,89800,43651.48000335693,0,0,0,0
270,271,180,0.0,89980,43651.48000335693,0,0,0,0
271,272,200,387.0899963378906,90180,44038.569999694824,0,0,0,0
272,273,100,273.1400146484375,90280,44311.71001434326,0,0,0,0
273,274,100,0.0,90380,44311.71001434326,0,0,0,0
274,275,300,273.239990234375,90680,44584.95000457764,0,0,0,0
275,276,300,341.54998779296875,90980,44926.499992370605,0,0,0,0
276,277,200,0.0,91180,44926.499992370605,0,0,0,0
277,278,200,318.7799987792969,91380,45245.2799911499,0,0,0,0
278,279,18860,14429.009765625,110240,59674.2897567749,0,0,0,0
279,280,16020,11120.1796875,126260,70794.4694442749,0,0,0,0
280,281,540,0.0,126800,70794.4694442749,0,0,0,0
281,282,280,0.0,127080,70794.4694442749,0,0,0,0
282,283,300,1298.2900390625,127380,72092.7594833374,0,0,0,0
283,284,260,22.770000457763672,127640,72115.52948379517,0,0,0,0
284,285,260,500.94000244140625,127900,72616.46948623657,0,0,0,0
285,286,300,364.32000732421875,128200,72980.78949356079,0,0,0,0
286,287,380,705.8699951171875,128580,73686.65948867798,0,0,0,0
287,288,560,0.0,129140,73686.65948867798,0,0,0,0
288,289,540,0.0,129680,73686.65948867798,0,0,0,0
289,290,300,0.0,129980,73686.65948867798,0,0,0,0
290,291,280,0.0,130260,73686.65948867798,0,0,0,0
291,292,300,0.0,130560,73686.65948867798,0,0,0,0
292,293,360,0.0,130920,73686.65948867798,0,0,0,0
293,294,260,0.0,131180,73686.65948867798,0,0,0,0
294,295,600,341.54998779296875,131780,74028.20947647095,0,0,0,0
295,296,160,0.0,131940,74028.20947647095,0,0,0,0
296,297,300,0.0,132240,74028.20947647095,0,0,0,0
297,298,300,0.0,132540,74028.20947647095,0,0,0,0
298,299,260,320.0299987792969,132800,74348.23947525024,0,0,0,0
299,300,500,1161.27001953125,133300,75509.5094947815,0,0,0,0
300,301,380,796.9500122070312,133680,76306.45950698853,0,0,0,0
301,302,500,455.70001220703125,134180,76762.15951919556,0,0,0,0
302,303,400,523.7100219726562,134580,77285.86954116821,0,0,0,0
303,304,140,0.0,134720,77285.86954116821,0,0,0,0
304,305,560,0.0,135280,77285.86954116821,0,0,0,0
305,306,400,296.010009765625,135680,77581.87955093384,0,0,0,0
306,307,560,431.44000244140625,136240,78013.31955337524,0,0,0,0
307,308,380,0.0,136620,78013.31955337524,0,0,0,0
308,309,180,0.0,136800,78013.31955337524,0,0,0,0
309,310,500,0.0,137300,78013.31955337524,0,0,0,0
310,311,400,0.0,137700,78013.31955337524,0,0,0,0
311,312,500,113.8499984741211,138200,78127.16955184937,0,0,0,0
312,313,400,797.0999755859375,138600,78924.2695274353,0,0,0,0
313,314,200,0.0,138800,78924.2695274353,0,0,0,0
314,315,300,432.6300048828125,139100,79356.89953231812,0,0,0,0
315,316,300,433.6199951171875,139400,79790.5195274353,0,0,0,0
316,317,180,296.010009765625,139580,80086.52953720093,0,0,0,0
317,318,300,0.0,139880,80086.52953720093,0,0,0,0
318,319,200,227.39999389648438,140080,80313.92953109741,0,0,0,0
319,320,240,500.94000244140625,140320,80814.86953353882,0,0,0,0
320,321,200,0.0,140520,80814.86953353882,0,0,0,0
321,322,200,159.38999938964844,140720,80974.25953292847,0,0,0,0
322,323,200,0.0,140920,80974.25953292847,0,0,0,0
323,324,180,159.38999938964844,141100,81133.64953231812,0,0,0,0
324,325,300,0.0,141400,81133.64953231812,0,0,0,0
325,326,160,432.5299987792969,141560,81566.17953109741,0,0,0,0
326,327,160,336.010009765625,141720,81902.18954086304,0,0,0,0
327,328,200,364.32000732421875,141920,82266.50954818726,0,0,0,0
328,329,200,0.0,142120,82266.50954818726,0,0,0,0
329,330,200,455.6000061035156,142320,82722.10955429077,0,0,0,0
330,331,200,91.08000183105469,142520,82813.18955612183,0,0,0,0
331,332,200,0.0,142720,82813.18955612183,0,0,0,0
332,333,180,0.0,142900,82813.18955612183,0,0,0,0
333,334,200,113.8499984741211,143100,82927.03955459595,0,0,0,0
334,335,200,341.54998779296875,143300,83268.58954238892,0,0,0,0
335,336,140,0.0,143440,83268.58954238892,0,0,0,0
336,337,180,0.0,143620,83268.58954238892,0,0,0,0
337,338,200,204.97999572753906,143820,83473.56953811646,0,0,0,0
338,339,280,0.0,144100,83473.56953811646,0,0,0,0
339,340,180,68.30999755859375,144280,83541.87953567505,0,0,0,0
340,341,200,0.0,144480,83541.87953567505,0,0,0,0
341,342,400,0.0,144880,83541.87953567505,0,0,0,0
342,343,340,0.0,145220,83541.87953567505,0,0,0,0
343,344,100,45.540000915527344,145320,83587.41953659058,0,0,0,0
344,345,160,0.0,145480,83587.41953659058,0,0,0,0
345,346,220,683.0999755859375,145700,84270.51951217651,0,0,0,0
346,347,300,0.0,146000,84270.51951217651,0,0,0,0
347,348,240,0.0,146240,84270.51951217651,0,0,0,0
348,349,380,0.0,146620,84270.51951217651,0,0,0,0
349,350,140,0.0,146760,84270.51951217651,0,0,0,0
350,351,180,0.0,146940,84270.51951217651,0,0,0,0
351,352,200,272.25,147140,84542.76951217651,0,0,0,0
352,353,300,0.0,147440,84542.76951217651,0,0,0,0
353,354,200,455.45001220703125,147640,84998.21952438354,0,0,0,0
354,355,160,0.0,147800,84998.21952438354,0,0,0,0
355,356,280,0.0,148080,84998.21952438354,0,0,0,0
356,357,120,0.0,148200,84998.21952438354,0,0,0,0
357,358,200,0.0,148400,84998.21952438354,0,0,0,0
358,359,120,0.0,148520,84998.21952438354,0,0,0,0
359,360,200,0.0,148720,84998.21952438354,0,0,0,0
360,361,320,0.0,149040,84998.21952438354,0,0,0,0
361,362,280,0.0,149320,84998.21952438354,0,0,0,0
362,363,200,432.6300048828125,149520,85430.84952926636,0,0,0,0
363,364,200,0.0,149720,85430.84952926636,0,0,0,0
364,365,17240,17283.380859375,166960,102714.23038864136,0,0,0,0
365,366,17780,15313.8203125,184740,118028.05070114136,0,0,0,0
366,367,440,1328.1800537109375,185180,119356.2307548523,0,0,0,0
367,368,280,563.2100219726562,185460,119919.44077682495,0,0,0,0
368,369,280,0.0,185740,119919.44077682495,0,0,0,0
369,370,180,568.9500122070312,185920,120488.39078903198,0,0,0,0
370,371,200,0.0,186120,120488.39078903198,0,0,0,0
371,372,280,774.1799926757812,186400,121262.57078170776,0,0,0,0
372,373,220,475.3999938964844,186620,121737.97077560425,0,0,0,0
373,374,280,0.0,186900,121737.97077560425,0,0,0,0
374,375,380,1544.4000244140625,187280,123282.37080001831,0,0,0,0
375,376,300,0.0,187580,123282.37080001831,0,0,0,0
376,377,280,0.0,187860,123282.37080001831,0,0,0,0
377,378,300,569.1500244140625,188160,123851.52082443237,0,0,0,0
378,379,220,933.5700073242188,188380,124785.09083175659,0,0,0,0
379,380,140,0.0,188520,124785.09083175659,0,0,0,0
380,381,400,0.0,188920,124785.09083175659,0,0,0,0
381,382,160,0.0,189080,124785.09083175659,0,0,0,0
382,383,280,746.4600219726562,189360,125531.55085372925,0,0,0,0
383,384,200,0.0,189560,125531.55085372925,0,0,0,0
384,385,280,836.9500122070312,189840,126368.50086593628,0,0,0,0
385,386,300,432.6300048828125,190140,126801.13087081909,0,0,0,0
386,387,300,683.0999755859375,190440,127484.23084640503,0,0,0,0
387,388,280,273.239990234375,190720,127757.4708366394,0,0,0,0
388,389,300,819.719970703125,191020,128577.19080734253,0,0,0,0
389,390,160,250.47000122070312,191180,128827.66080856323,0,0,0,0
390,391,220,0.0,191400,128827.66080856323,0,0,0,0
391,392,300,91.08000183105469,191700,128918.74081039429,0,0,0,0
392,393,300,296.010009765625,192000,129214.75082015991,0,0,0,0
393,394,360,0.0,192360,129214.75082015991,0,0,0,0
394,395,180,0.0,192540,129214.75082015991,0,0,0,0
395,396,300,0.0,192840,129214.75082015991,0,0,0,0
396,397,300,865.2100219726562,193140,130079.96084213257,0,0,0,0
397,398,280,296.010009765625,193420,130375.9708518982,0,0,0,0
398,399,300,0.0,193720,130375.9708518982,0,0,0,0
399,400,400,517.030029296875,194120,130893.00088119507,0,0,0,0
400,401,400,0.0,194520,130893.00088119507,0,0,0,0
401,402,460,0.0,194980,130893.00088119507,0,0,0,0
402,403,400,227.6999969482422,195380,131120.7008781433,0,0,0,0
403,404,480,683.0999755859375,195860,131803.80085372925,0,0,0,0
404,405,280,0.0,196140,131803.80085372925,0,0,0,0
405,406,300,0.0,196440,131803.80085372925,0,0,0,0
406,407,500,614.8900146484375,196940,132418.6908683777,0,0,0,0
407,408,300,227.6999969482422,197240,132646.39086532593,0,0,0,0
408,409,280,728.5900268554688,197520,133374.9808921814,0,0,0,0
409,410,280,387.0899963378906,197800,133762.0708885193,0,0,0,0
410,411,480,683.0999755859375,198280,134445.17086410522,0,0,0,0
411,412,200,0.0,198480,134445.17086410522,0,0,0,0
412,413,300,0.0,198780,134445.17086410522,0,0,0,0
413,414,200,0.0,198980,134445.17086410522,0,0,0,0
414,415,260,0.0,199240,134445.17086410522,0,0,0,0
415,416,300,0.0,199540,134445.17086410522,0,0,0,0
416,417,300,0.0,199840,134445.17086410522,0,0,0,0
417,418,280,592.02001953125,200120,135037.19088363647,0,0,0,0
418,419,200,614.3400268554688,200320,135651.53091049194,0,0,0,0
419,420,20,728.6400146484375,200340,136380.17092514038,0,0,0,0
420,421,500,774.1799926757812,200840,137154.35091781616,0,0,0,0
421,422,200,68.30999755859375,201040,137222.66091537476,0,0,0,0
422,423,300,0.0,201340,137222.66091537476,0,0,0,0
423,424,200,409.8599853515625,201540,137632.52090072632,0,0,0,0
424,425,360,774.1799926757812,201900,138406.7008934021,0,0,0,0
425,426,140,181.47000122070312,202040,138588.1708946228,0,0,0,0
426,427,300,949.989990234375,202340,139538.16088485718,0,0,0,0
427,428,200,364.32000732421875,202540,139902.4808921814,0,0,0,0
428,429,400,728.6400146484375,202940,140631.12090682983,0,0,0,0
429,430,300,774.22998046875,203240,141405.35088729858,0,0,0,0
430,431,300,796.5,203540,142201.85088729858,0,0,0,0
431,432,380,432.6300048828125,203920,142634.4808921814,0,0,0,0
432,433,100,204.6300048828125,204020,142839.1108970642,0,0,0,0
433,434,200,660.280029296875,204220,143499.39092636108,0,0,0,0
434,435,300,0.0,204520,143499.39092636108,0,0,0,0
435,436,280,705.8699951171875,204800,144205.26092147827,0,0,0,0
436,437,160,683.0999755859375,204960,144888.3608970642,0,0,0,0
437,438,300,771.9000244140625,205260,145660.26092147827,0,0,0,0
438,439,60,22.719999313354492,205320,145682.98092079163,0,0,0,0
439,440,200,683.0999755859375,205520,146366.08089637756,0,0,0,0
440,441,180,409.8599853515625,205700,146775.94088172913,0,0,0,0
441,442,200,432.7300109863281,205900,147208.67089271545,0,0,0,0
442,443,180,0.0,206080,147208.67089271545,0,0,0,0
443,444,200,364.32000732421875,206280,147572.99090003967,0,0,0,0
444,445,160,455.3999938964844,206440,148028.39089393616,0,0,0,0
445,446,160,318.7799987792969,206600,148347.17089271545,0,0,0,0
446,447,200,318.7799987792969,206800,148665.95089149475,0,0,0,0
447,448,160,0.0,206960,148665.95089149475,0,0,0,0
448,449,200,500.94000244140625,207160,149166.89089393616,0,0,0,0
449,450,300,273.239990234375,207460,149440.13088417053,0,0,0,0
450,451,280,774.1799926757812,207740,150214.3108768463,0,0,0,0
451,452,200,432.6300048828125,207940,150646.94088172913,0,0,0,0
452,453,200,432.6300048828125,208140,151079.57088661194,0,0,0,0
453,454,12400,16204.400390625,220540,167283.97127723694,0,0,0,0
454,455,12220,18875.849609375,232760,186159.82088661194,0,0,0,0
455,456,0,0.0,232760,186159.82088661194,0,0,0,0
456,457,0,0.0,232760,186159.82088661194,0,0,0,0
457,458,0,296.010009765625,232760,186455.83089637756,0,0,0,0
458,459,0,0.0,232760,186455.83089637756,0,0,0,0
459,460,0,0.0,232760,186455.83089637756,0,0,0,0
460,461,0,159.38999938964844,232760,186615.2208957672,0,0,0,0
461,462,0,159.38999938964844,232760,186774.61089515686,0,0,0,0
462,463,0,0.0,232760,186774.61089515686,0,0,0,0
463,464,0,819.6699829101562,232760,187594.28087806702,0,0,0,0
464,465,0,0.0,232760,187594.28087806702,0,0,0,0
465,466,40,614.4400024414062,232800,188208.72088050842,0,0,0,0
466,467,0,819.719970703125,232800,189028.44085121155,0,0,0,0
467,468,0,613.6500244140625,232800,189642.0908756256,0,0,0,0
468,469,0,614.6900024414062,232800,190256.78087806702,0,0,0,0
469,470,0,0.0,232800,190256.78087806702,0,0,0,0
470,471,0,796.9500122070312,232800,191053.73089027405,0,0,0,0
471,472,0,217.05999755859375,232800,191270.79088783264,0,0,0,0
472,473,0,819.719970703125,232800,192090.51085853577,0,0,0,0
473,474,0,159.38999938964844,232800,192249.90085792542,0,0,0,0
474,475,0,0.0,232800,192249.90085792542,0,0,0,0
475,476,0,341.54998779296875,232800,192591.45084571838,0,0,0,0
476,477,0,45.540000915527344,232800,192636.9908466339,0,0,0,0
477,478,0,979.9000244140625,232800,193616.89087104797,0,0,0,0
478,479,0,654.5900268554688,232800,194271.48089790344,0,0,0,0
479,480,0,113.8499984741211,232800,194385.33089637756,0,0,0,0
480,481,20,842.489990234375,232820,195227.82088661194,0,0,0,0
481,482,0,521.47998046875,232820,195749.3008670807,0,0,0,0
482,483,0,1001.8800048828125,232820,196751.1808719635,0,0,0,0
483,484,0,227.6999969482422,232820,196978.88086891174,0,0,0,0
484,485,0,273.239990234375,232820,197252.12085914612,0,0,0,0
485,486,0,705.719970703125,232820,197957.84082984924,0,0,0,0
486,487,0,0.0,232820,197957.84082984924,0,0,0,0
487,488,0,660.3300170898438,232820,198618.1708469391,0,0,0,0
488,489,0,660.3300170898438,232820,199278.50086402893,0,0,0,0
489,490,0,273.239990234375,232820,199551.7408542633,0,0,0,0
490,491,460,364.80999755859375,233280,199916.5508518219,0,0,0,0
491,492,0,341.54998779296875,233280,200258.10083961487,0,0,0,0
492,493,0,569.25,233280,200827.35083961487,0,0,0,0
493,494,0,113.8499984741211,233280,200941.200838089,0,0,0,0
494,495,0,409.8599853515625,233280,201351.06082344055,0,0,0,0
495,496,380,318.67999267578125,233660,201669.74081611633,0,0,0,0
496,497,0,0.0,233660,201669.74081611633,0,0,0,0
497,498,0,0.0,233660,201669.74081611633,0,0,0,0
498,499,0,455.3999938964844,233660,202125.14081001282,0,0,0,0
499,500,0,409.8599853515625,233660,202535.00079536438,0,0,0,0
500,501,0,796.9500122070312,233660,203331.9508075714,0,0,0,0
501,502,0,569.2999877929688,233660,203901.25079536438,0,0,0,0
502,503,0,592.02001953125,233660,204493.27081489563,0,0,0,0
503,504,0,0.0,233660,204493.27081489563,0,0,0,0
504,505,0,0.0,233660,204493.27081489563,0,0,0,0
505,506,0,0.0,233660,204493.27081489563,0,0,0,0
506,507,0,45.540000915527344,233660,204538.81081581116,0,0,0,0
507,508,0,546.5700073242188,233660,205085.38082313538,0,0,0,0
508,509,0,136.6199951171875,233660,205222.00081825256,0,0,0,0
509,510,0,250.47000122070312,233660,205472.47081947327,0,0,0,0
510,511,0,364.2200012207031,233660,205836.69082069397,0,0,0,0
511,512,380,456.1400146484375,234040,206292.8308353424,0,0,0,0
512,513,0,0.0,234040,206292.8308353424,0,0,0,0
513,514,400,0.0,234440,206292.8308353424,0,0,0,0
514,515,0,182.11000061035156,234440,206474.94083595276,0,0,0,0
515,516,0,68.20999908447266,234440,206543.15083503723,0,0,0,0
516,517,0,0.0,234440,206543.15083503723,0,0,0,0
517,518,0,0.0,234440,206543.15083503723,0,0,0,0
518,519,0,296.010009765625,234440,206839.16084480286,0,0,0,0
519,520,0,0.0,234440,206839.16084480286,0,0,0,0
520,521,0,136.6199951171875,234440,206975.78083992004,0,0,0,0
521,522,0,68.11000061035156,234440,207043.8908405304,0,0,0,0
522,523,0,0.0,234440,207043.8908405304,0,0,0,0
523,524,0,273.239990234375,234440,207317.13083076477,0,0,0,0
524,525,0,273.239990234375,234440,207590.37082099915,0,0,0,0
525,526,0,364.3500061035156,234440,207954.72082710266,0,0,0,0
526,527,0,0.0,234440,207954.72082710266,0,0,0,0
527,528,0,45.540000915527344,234440,208000.2608280182,0,0,0,0
528,529,0,136.6199951171875,234440,208136.88082313538,0,0,0,0
529,530,0,91.08000183105469,234440,208227.96082496643,0,0,0,0
530,531,0,341.3999938964844,234440,208569.36081886292,0,0,0,0
531,532,0,273.239990234375,234440,208842.6008090973,0,0,0,0
532,533,0,432.6300048828125,234440,209275.2308139801,0,0,0,0
533,534,0,0.0,234440,209275.2308139801,0,0,0,0
534,535,0,182.16000366210938,234440,209457.3908176422,0,0,0,0
535,536,0,0.0,234440,209457.3908176422,0,0,0,0
536,537,16920,16213.7900390625,251360,225671.1808567047,0,0,0,0
537,538,22740,19008.720703125,274100,244679.9015598297,0,0,0,0
538,539,380,580.6900024414062,274480,245260.59156227112,0,0,0,0
539,540,380,318.7799987792969,274860,245579.37156105042,0,0,0,0
540,541,0,318.7799987792969,274860,245898.1515598297,0,0,0,0
541,542,200,545.0800170898438,275060,246443.23157691956,0,0,0,0
542,543,180,432.6300048828125,275240,246875.86158180237,0,0,0,0
543,544,260,341.54998779296875,275500,247217.41156959534,0,0,0,0
544,545,400,273.239990234375,275900,247490.6515598297,0,0,0,0
545,546,360,994.9000244140625,276260,248485.55158424377,0,0,0,0
546,547,380,364.32000732421875,276640,248849.871591568,0,0,0,0
547,548,300,0.0,276940,248849.871591568,0,0,0,0
548,549,0,728.6400146484375,276940,249578.51160621643,0,0,0,0
549,550,400,0.0,277340,249578.51160621643,0,0,0,0
550,551,360,0.0,277700,249578.51160621643,0,0,0,0
551,552,360,0.0,278060,249578.51160621643,0,0,0,0
552,553,300,45.540000915527344,278360,249624.05160713196,0,0,0,0
553,554,180,227.4499969482422,278540,249851.5016040802,0,0,0,0
554,555,280,250.47000122070312,278820,250101.9716053009,0,0,0,0
555,556,280,0.0,279100,250101.9716053009,0,0,0,0
556,557,500,384.4700012207031,279600,250486.4416065216,0,0,0,0
557,558,180,0.0,279780,250486.4416065216,0,0,0,0
558,559,460,0.0,280240,250486.4416065216,0,0,0,0
559,560,0,159.38999938964844,280240,250645.83160591125,0,0,0,0
560,561,580,364.32000732421875,280820,251010.15161323547,0,0,0,0
561,562,120,45.540000915527344,280940,251055.691614151,0,0,0,0
562,563,100,0.0,281040,251055.691614151,0,0,0,0
563,564,400,227.6999969482422,281440,251283.39161109924,0,0,0,0
564,565,580,432.6300048828125,282020,251716.02161598206,0,0,0,0
565,566,380,296.010009765625,282400,252012.03162574768,0,0,0,0
566,567,280,0.0,282680,252012.03162574768,0,0,0,0
567,568,400,387.0899963378906,283080,252399.12162208557,0,0,0,0
568,569,380,364.32000732421875,283460,252763.4416294098,0,0,0,0
569,570,300,204.92999267578125,283760,252968.37162208557,0,0,0,0
570,571,400,91.05999755859375,284160,253059.43161964417,0,0,0,0
571,572,380,546.47998046875,284540,253605.91160011292,0,0,0,0
572,573,400,0.0,284940,253605.91160011292,0,0,0,0
573,574,400,364.32000732421875,285340,253970.23160743713,0,0,0,0
574,575,600,500.94000244140625,285940,254471.17160987854,0,0,0,0
575,576,560,478.1700134277344,286500,254949.34162330627,0,0,0,0
576,577,400,204.92999267578125,286900,255154.27161598206,0,0,0,0
577,578,400,0.0,287300,255154.27161598206,0,0,0,0
578,579,500,432.5799865722656,287800,255586.85160255432,0,0,0,0
579,580,500,273.239990234375,288300,255860.0915927887,0,0,0,0
580,581,400,614.739990234375,288700,256474.83158302307,0,0,0,0
581,582,360,364.32000732421875,289060,256839.1515903473,0,0,0,0
582,583,200,250.47000122070312,289260,257089.621591568,0,0,0,0
583,584,140,406.989990234375,289400,257496.61158180237,0,0,0,0
584,585,280,316.010009765625,289680,257812.621591568,0,0,0,0
585,586,160,0.0,289840,257812.621591568,0,0,0,0
586,587,180,0.0,290020,257812.621591568,0,0,0,0
587,588,380,227.6999969482422,290400,258040.32158851624,0,0,0,0
588,589,280,341.54998779296875,290680,258381.8715763092,0,0,0,0
589,590,340,341.54998779296875,291020,258723.42156410217,0,0,0,0
590,591,300,273.239990234375,291320,258996.66155433655,0,0,0,0
591,592,300,296.010009765625,291620,259292.67156410217,0,0,0,0
592,593,460,478.1700134277344,292080,259770.8415775299,0,0,0,0
593,594,360,204.92999267578125,292440,259975.7715702057,0,0,0,0
594,595,300,296.010009765625,292740,260271.7815799713,0,0,0,0
595,596,300,227.6999969482422,293040,260499.48157691956,0,0,0,0
596,597,300,273.239990234375,293340,260772.72156715393,0,0,0,0
597,598,280,250.47000122070312,293620,261023.19156837463,0,0,0,0
598,599,480,387.0899963378906,294100,261410.28156471252,0,0,0,0
599,600,280,341.54998779296875,294380,261751.8315525055,0,0,0,0
600,601,480,728.6400146484375,294860,262480.47156715393,0,0,0,0
601,602,480,250.47000122070312,295340,262730.94156837463,0,0,0,0
602,603,380,159.33999633789062,295720,262890.2815647125,0,0,0,0
603,604,380,820.4600219726562,296100,263710.7415866852,0,0,0,0
604,605,180,91.08000183105469,296280,263801.82158851624,0,0,0,0
605,606,260,432.6300048828125,296540,264234.45159339905,0,0,0,0
606,607,300,204.92999267578125,296840,264439.3815860748,0,0,0,0
607,608,300,273.239990234375,297140,264712.6215763092,0,0,0,0
608,609,300,364.32000732421875,297440,265076.9415836334,0,0,0,0
609,610,400,250.47000122070312,297840,265327.4115848541,0,0,0,0
610,611,140,113.75,297980,265441.1615848541,0,0,0,0
611,612,200,341.54998779296875,298180,265782.7115726471,0,0,0,0
612,613,300,136.6199951171875,298480,265919.3315677643,0,0,0,0
613,614,300,273.1400146484375,298780,266192.4715824127,0,0,0,0
614,615,200,0.0,298980,266192.4715824127,0,0,0,0
615,616,200,318.7799987792969,299180,266511.251581192,0,0,0,0
616,617,380,318.7799987792969,299560,266830.0315799713,0,0,0,0
617,618,160,250.47000122070312,299720,267080.501581192,0,0,0,0
618,619,300,272.70001220703125,300020,267353.20159339905,0,0,0,0
619,620,200,68.30999755859375,300220,267421.51159095764,0,0,0,0
620,621,280,0.0,300500,267421.51159095764,0,0,0,0
621,622,380,250.47000122070312,300880,267671.98159217834,0,0,0,0
622,623,400,478.1700134277344,301280,268150.1516056061,0,0,0,0
623,624,300,227.6999969482422,301580,268377.8516025543,0,0,0,0
624,625,280,318.7799987792969,301860,268696.6316013336,0,0,0,0
625,626,14760,13923.759765625,316620,282620.3913669586,0,0,0,0
626,627,20800,16856.310546875,337420,299476.7019138336,0,0,0,0
627,628,160,384.8599853515625,337580,299861.5618991852,0,0,0,0
628,629,280,250.47000122070312,337860,300112.0319004059,0,0,0,0
629,630,300,204.92999267578125,338160,300316.96189308167,0,0,0,0
630,631,200,0.0,338360,300316.96189308167,0,0,0,0
631,632,200,0.0,338560,300316.96189308167,0,0,0,0
632,633,220,296.010009765625,338780,300612.9719028473,0,0,0,0
633,634,360,341.54998779296875,339140,300954.52189064026,0,0,0,0
634,635,0,332.5400085449219,339140,301287.0618991852,0,0,0,0
635,636,280,204.92999267578125,339420,301491.99189186096,0,0,0,0
636,637,300,500.04998779296875,339720,301992.04187965393,0,0,0,0
637,638,280,0.0,340000,301992.04187965393,0,0,0,0
638,639,400,682.9000244140625,340400,302674.941904068,0,0,0,0
639,640,180,614.7899780273438,340580,303289.73188209534,0,0,0,0
640,641,220,273.239990234375,340800,303562.9718723297,0,0,0,0
641,642,360,409.8599853515625,341160,303972.8318576813,0,0,0,0
642,643,200,0.0,341360,303972.8318576813,0,0,0,0
643,644,280,0.0,341640,303972.8318576813,0,0,0,0
644,645,0,296.010009765625,341640,304268.8418674469,0,0,0,0
645,646,540,0.0,342180,304268.8418674469,0,0,0,0
646,647,280,227.6999969482422,342460,304496.54186439514,0,0,0,0
647,648,360,68.30999755859375,342820,304564.85186195374,0,0,0,0
648,649,360,159.33999633789062,343180,304724.1918582916,0,0,0,0
649,650,560,0.0,343740,304724.1918582916,0,0,0,0
650,651,200,0.0,343940,304724.1918582916,0,0,0,0
651,652,0,361.3500061035156,343940,305085.54186439514,0,0,0,0
652,653,280,318.7799987792969,344220,305404.32186317444,0,0,0,0
653,654,560,455.3999938964844,344780,305859.7218570709,0,0,0,0
654,655,400,500.94000244140625,345180,306360.6618595123,0,0,0,0
655,656,0,250.32000732421875,345180,306610.98186683655,0,0,0,0
656,657,400,409.8599853515625,345580,307020.8418521881,0,0,0,0
657,658,500,569.25,346080,307590.0918521881,0,0,0,0
658,659,380,409.8599853515625,346460,307999.9518375397,0,0,0,0
659,660,400,364.32000732421875,346860,308364.2718448639,0,0,0,0
660,661,400,136.6199951171875,347260,308500.8918399811,0,0,0,0
661,662,380,569.25,347640,309070.1418399811,0,0,0,0
662,663,500,204.92999267578125,348140,309275.07183265686,0,0,0,0
663,664,600,296.010009765625,348740,309571.0818424225,0,0,0,0
664,665,680,478.1700134277344,349420,310049.2518558502,0,0,0,0
665,666,400,204.92999267578125,349820,310254.181848526,0,0,0,0
666,667,400,546.47998046875,350220,310800.66182899475,0,0,0,0
667,668,480,523.7100219726562,350700,311324.3718509674,0,0,0,0
668,669,580,0.0,351280,311324.3718509674,0,0,0,0
669,670,500,341.5,351780,311665.8718509674,0,0,0,0
670,671,340,455.3999938964844,352120,312121.2718448639,0,0,0,0
671,672,400,273.239990234375,352520,312394.51183509827,0,0,0,0
672,673,280,182.16000366210938,352800,312576.6718387604,0,0,0,0
673,674,300,250.47000122070312,353100,312827.1418399811,0,0,0,0
674,675,180,387.0899963378906,353280,313214.23183631897,0,0,0,0
675,676,300,409.8599853515625,353580,313624.09182167053,0,0,0,0
676,677,400,364.32000732421875,353980,313988.41182899475,0,0,0,0
677,678,280,273.239990234375,354260,314261.6518192291,0,0,0,0
678,679,360,204.92999267578125,354620,314466.5818119049,0,0,0,0
679,680,300,0.0,354920,314466.5818119049,0,0,0,0
680,681,260,0.0,355180,314466.5818119049,0,0,0,0
681,682,600,546.47998046875,355780,315013.06179237366,0,0,0,0
682,683,300,0.0,356080,315013.06179237366,0,0,0,0
683,684,300,250.47000122070312,356380,315263.53179359436,0,0,0,0
684,685,260,182.16000366210938,356640,315445.69179725647,0,0,0,0
685,686,380,318.7799987792969,357020,315764.47179603577,0,0,0,0
686,687,280,364.32000732421875,357300,316128.79180336,0,0,0,0
687,688,500,318.7799987792969,357800,316447.5718021393,0,0,0,0
688,689,280,341.54998779296875,358080,316789.12178993225,0,0,0,0
689,690,400,227.6999969482422,358480,317016.8217868805,0,0,0,0
690,691,500,296.010009765625,358980,317312.8317966461,0,0,0,0
691,692,280,341.45001220703125,359260,317654.28180885315,0,0,0,0
692,693,500,159.38999938964844,359760,317813.6718082428,0,0,0,0
693,694,200,68.30999755859375,359960,317881.9818058014,0,0,0,0
694,695,200,341.54998779296875,360160,318223.53179359436,0,0,0,0
695,696,360,409.80999755859375,360520,318633.34179115295,0,0,0,0
696,697,280,387.0899963378906,360800,319020.43178749084,0,0,0,0
697,698,260,250.47000122070312,361060,319270.90178871155,0,0,0,0
698,699,400,455.29998779296875,361460,319726.2017765045,0,0,0,0
699,700,160,273.0899963378906,361620,319999.2917728424,0,0,0,0
700,701,200,227.6999969482422,361820,320226.99176979065,0,0,0,0
701,702,300,432.6300048828125,362120,320659.62177467346,0,0,0,0
702,703,300,296.010009765625,362420,320955.6317844391,0,0,0,0
703,704,200,432.6300048828125,362620,321388.2617893219,0,0,0,0
704,705,200,0.0,362820,321388.2617893219,0,0,0,0
705,706,300,250.47000122070312,363120,321638.7317905426,0,0,0,0
706,707,200,136.6199951171875,363320,321775.3517856598,0,0,0,0
707,708,240,341.54998779296875,363560,322116.90177345276,0,0,0,0
708,709,200,250.47000122070312,363760,322367.37177467346,0,0,0,0
709,710,300,455.3999938964844,364060,322822.77176856995,0,0,0,0
710,711,400,432.6300048828125,364460,323255.40177345276,0,0,0,0
711,712,400,0.0,364860,323255.40177345276,0,0,0,0
712,713,300,273.239990234375,365160,323528.64176368713,0,0,0,0
713,714,300,250.47000122070312,365460,323779.11176490784,0,0,0,0
714,715,13180,16186.2900390625,378640,339965.40180397034,0,0,0,0
715,716,14540,21688.849609375,393180,361654.25141334534,0,0,0,0
716,717,380,0.0,393560,361654.25141334534,0,0,0,0
717,718,200,0.0,393760,361654.25141334534,0,0,0,0
718,719,300,182.16000366210938,394060,361836.41141700745,0,0,0,0
719,720,200,296.010009765625,394260,362132.4214267731,0,0,0,0
720,721,200,0.0,394460,362132.4214267731,0,0,0,0
721,722,280,22.770000457763672,394740,362155.19142723083,0,0,0,0
722,723,260,159.38999938964844,395000,362314.5814266205,0,0,0,0
723,724,280,227.6999969482422,395280,362542.2814235687,0,0,0,0
724,725,300,136.6199951171875,395580,362678.9014186859,0,0,0,0
725,726,300,182.16000366210938,395880,362861.061422348,0,0,0,0
726,727,300,273.239990234375,396180,363134.3014125824,0,0,0,0
727,728,300,0.0,396480,363134.3014125824,0,0,0,0
728,729,300,0.0,396780,363134.3014125824,0,0,0,0
729,730,200,0.0,396980,363134.3014125824,0,0,0,0
730,731,300,478.1700134277344,397280,363612.47142601013,0,0,0,0
731,732,260,0.0,397540,363612.47142601013,0,0,0,0
732,733,200,500.8900146484375,397740,364113.36144065857,0,0,0,0
733,734,300,0.0,398040,364113.36144065857,0,0,0,0
734,735,340,296.010009765625,398380,364409.3714504242,0,0,0,0
735,736,360,250.47000122070312,398740,364659.8414516449,0,0,0,0
736,737,300,204.92999267578125,399040,364864.7714443207,0,0,0,0
737,738,160,0.0,399200,364864.7714443207,0,0,0,0
738,739,300,0.0,399500,364864.7714443207,0,0,0,0
739,740,360,318.7799987792969,399860,365183.5514431,0,0,0,0
740,741,460,317.7900085449219,400320,365501.3414516449,0,0,0,0
741,742,500,250.47000122070312,400820,365751.8114528656,0,0,0,0
742,743,200,113.80000305175781,401020,365865.61145591736,0,0,0,0
743,744,500,91.08000183105469,401520,365956.6914577484,0,0,0,0
744,745,500,387.1400146484375,402020,366343.83147239685,0,0,0,0
745,746,400,250.47000122070312,402420,366594.30147361755,0,0,0,0
746,747,400,0.0,402820,366594.30147361755,0,0,0,0
747,748,300,136.6199951171875,403120,366730.92146873474,0,0,0,0
748,749,300,0.0,403420,366730.92146873474,0,0,0,0
749,750,400,250.47000122070312,403820,366981.39146995544,0,0,0,0
750,751,500,614.7899780273438,404320,367596.1814479828,0,0,0,0
751,752,600,113.8499984741211,404920,367710.0314464569,0,0,0,0
752,753,300,409.80999755859375,405220,368119.8414440155,0,0,0,0
753,754,300,0.0,405520,368119.8414440155,0,0,0,0
754,755,400,250.47000122070312,405920,368370.3114452362,0,0,0,0
755,756,340,637.4600219726562,406260,369007.77146720886,0,0,0,0
756,757,400,0.0,406660,369007.77146720886,0,0,0,0
757,758,300,0.0,406960,369007.77146720886,0,0,0,0
758,759,380,387.0899963378906,407340,369394.86146354675,0,0,0,0
759,760,240,0.0,407580,369394.86146354675,0,0,0,0
760,761,300,247.6999969482422,407880,369642.561460495,0,0,0,0
761,762,200,0.0,408080,369642.561460495,0,0,0,0
762,763,260,0.0,408340,369642.561460495,0,0,0,0
763,764,280,250.47000122070312,408620,369893.0314617157,0,0,0,0
764,765,280,0.0,408900,369893.0314617157,0,0,0,0
765,766,260,113.8499984741211,409160,370006.8814601898,0,0,0,0
766,767,200,409.8599853515625,409360,370416.7414455414,0,0,0,0
767,768,200,0.0,409560,370416.7414455414,0,0,0,0
768,769,400,113.8499984741211,409960,370530.5914440155,0,0,0,0
769,770,180,204.92999267578125,410140,370735.5214366913,0,0,0,0
770,771,300,0.0,410440,370735.5214366913,0,0,0,0
771,772,200,113.8499984741211,410640,370849.3714351654,0,0,0,0
772,773,300,0.0,410940,370849.3714351654,0,0,0,0
773,774,200,0.0,411140,370849.3714351654,0,0,0,0
774,775,400,204.92999267578125,411540,371054.3014278412,0,0,0,0
775,776,300,0.0,411840,371054.3014278412,0,0,0,0
776,777,300,113.8499984741211,412140,371168.1514263153,0,0,0,0
777,778,300,0.0,412440,371168.1514263153,0,0,0,0
778,779,300,0.0,412740,371168.1514263153,0,0,0,0
779,780,400,0.0,413140,371168.1514263153,0,0,0,0
780,781,200,0.0,413340,371168.1514263153,0,0,0,0
781,782,140,182.16000366210938,413480,371350.3114299774,0,0,0,0
782,783,300,273.239990234375,413780,371623.5514202118,0,0,0,0
783,784,300,227.6999969482422,414080,371851.25141716003,0,0,0,0
784,785,200,0.0,414280,371851.25141716003,0,0,0,0
785,786,300,295.9100036621094,414580,372147.16142082214,0,0,0,0
786,787,120,0.0,414700,372147.16142082214,0,0,0,0
787,788,200,182.16000366210938,414900,372329.32142448425,0,0,0,0
788,789,280,0.0,415180,372329.32142448425,0,0,0,0
789,790,300,318.7799987792969,415480,372648.10142326355,0,0,0,0
790,791,200,0.0,415680,372648.10142326355,0,0,0,0
791,792,180,0.0,415860,372648.10142326355,0,0,0,0
792,793,200,0.0,416060,372648.10142326355,0,0,0,0
793,794,160,0.0,416220,372648.10142326355,0,0,0,0
794,795,260,0.0,416480,372648.10142326355,0,0,0,0
795,796,200,0.0,416680,372648.10142326355,0,0,0,0
796,797,200,0.0,416880,372648.10142326355,0,0,0,0
797,798,380,182.16000366210938,417260,372830.26142692566,0,0,0,0
798,799,300,546.47998046875,417560,373376.7414073944,0,0,0,0
799,800,260,0.0,417820,373376.7414073944,0,0,0,0
800,801,300,182.16000366210938,418120,373558.9014110565,0,0,0,0
801,802,7600,13635.599609375,425720,387194.5010204315,0,0,0,0
802,803,19040,19624.109375,444760,406818.6103954315,0,0,0,0
803,804,160,91.08000183105469,444920,406909.6903972626,0,0,0,0
804,805,300,576.1300048828125,445220,407485.8204021454,0,0,0,0
805,806,200,500.8399963378906,445420,407986.6603984833,0,0,0,0
806,807,160,0.0,445580,407986.6603984833,0,0,0,0
807,808,300,182.16000366210938,445880,408168.8204021454,0,0,0,0
808,809,200,387.0899963378906,446080,408555.9103984833,0,0,0,0
809,810,260,227.6999969482422,446340,408783.6103954315,0,0,0,0
810,811,180,592.02001953125,446520,409375.63041496277,0,0,0,0
811,812,160,432.6300048828125,446680,409808.2604198456,0,0,0,0
812,813,280,660.3300170898438,446960,410468.5904369354,0,0,0,0
813,814,180,266.45001220703125,447140,410735.04044914246,0,0,0,0
814,815,300,387.0899963378906,447440,411122.13044548035,0,0,0,0
815,816,180,0.0,447620,411122.13044548035,0,0,0,0
816,817,280,455.3500061035156,447900,411577.48045158386,0,0,0,0
817,818,200,387.0899963378906,448100,411964.57044792175,0,0,0,0
818,819,200,91.08000183105469,448300,412055.6504497528,0,0,0,0
819,820,200,748.3900146484375,448500,412804.04046440125,0,0,0,0
820,821,280,478.1700134277344,448780,413282.210477829,0,0,0,0
821,822,200,159.38999938964844,448980,413441.6004772186,0,0,0,0
822,823,200,546.47998046875,449180,413988.0804576874,0,0,0,0
823,824,300,409.8599853515625,449480,414397.94044303894,0,0,0,0
824,825,180,477.42999267578125,449660,414875.3704357147,0,0,0,0
825,826,160,91.08000183105469,449820,414966.4504375458,0,0,0,0
826,827,180,182.16000366210938,450000,415148.6104412079,0,0,0,0
827,828,200,341.54998779296875,450200,415490.16042900085,0,0,0,0
828,829,200,0.0,450400,415490.16042900085,0,0,0,0
829,830,200,842.8900146484375,450600,416333.0504436493,0,0,0,0
830,831,200,159.38999938964844,450800,416492.44044303894,0,0,0,0
831,832,200,45.540000915527344,451000,416537.98044395447,0,0,0,0
832,833,300,159.38999938964844,451300,416697.3704433441,0,0,0,0
833,834,200,68.30999755859375,451500,416765.6804409027,0,0,0,0
834,835,160,387.0899963378906,451660,417152.7704372406,0,0,0,0
835,836,180,478.1700134277344,451840,417630.94045066833,0,0,0,0
836,837,180,45.38999938964844,452020,417676.330450058,0,0,0,0
837,838,160,341.54998779296875,452180,418017.88043785095,0,0,0,0
838,839,300,842.489990234375,452480,418860.3704280853,0,0,0,0
839,840,140,296.010009765625,452620,419156.38043785095,0,0,0,0
840,841,160,0.0,452780,419156.38043785095,0,0,0,0
841,842,140,317.7900085449219,452920,419474.1704463959,0,0,0,0
842,843,260,523.5599975585938,453180,419997.73044395447,0,0,0,0
843,844,400,500.94000244140625,453580,420498.6704463959,0,0,0,0
844,845,0,523.7100219726562,453580,421022.38046836853,0,0,0,0
845,846,160,0.0,453740,421022.38046836853,0,0,0,0
846,847,200,68.30999755859375,453940,421090.6904659271,0,0,0,0
847,848,300,500.94000244140625,454240,421591.63046836853,0,0,0,0
848,849,300,660.3300170898438,454540,422251.9604854584,0,0,0,0
849,850,300,364.32000732421875,454840,422616.2804927826,0,0,0,0
850,851,200,113.8499984741211,455040,422730.1304912567,0,0,0,0
851,852,200,68.30999755859375,455240,422798.4404888153,0,0,0,0
852,853,300,842.4400024414062,455540,423640.8804912567,0,0,0,0
853,854,200,0.0,455740,423640.8804912567,0,0,0,0
854,855,300,683.0999755859375,456040,424323.98046684265,0,0,0,0
855,856,300,774.1799926757812,456340,425098.16045951843,0,0,0,0
856,857,280,478.1700134277344,456620,425576.33047294617,0,0,0,0
857,858,400,364.32000732421875,457020,425940.6504802704,0,0,0,0
858,859,480,819.219970703125,457500,426759.8704509735,0,0,0,0
859,860,300,455.3999938964844,457800,427215.27044487,0,0,0,0
860,861,300,705.8699951171875,458100,427921.1404399872,0,0,0,0
861,862,380,432.6300048828125,458480,428353.77044487,0,0,0,0
862,863,380,432.6300048828125,458860,428786.4004497528,0,0,0,0
863,864,380,774.22998046875,459240,429560.63043022156,0,0,0,0
864,865,280,273.239990234375,459520,429833.87042045593,0,0,0,0
865,866,300,523.7100219726562,459820,430357.5804424286,0,0,0,0
866,867,200,518.1699829101562,460020,430875.75042533875,0,0,0,0
867,868,300,227.6999969482422,460320,431103.450422287,0,0,0,0
868,869,200,250.47000122070312,460520,431353.9204235077,0,0,0,0
869,870,300,432.5799865722656,460820,431786.50041007996,0,0,0,0
870,871,300,273.239990234375,461120,432059.74040031433,0,0,0,0
871,872,280,455.3500061035156,461400,432515.09040641785,0,0,0,0
872,873,240,478.1700134277344,461640,432993.2604198456,0,0,0,0
873,874,200,0.0,461840,432993.2604198456,0,0,0,0
874,875,200,569.25,462040,433562.5104198456,0,0,0,0
875,876,400,592.02001953125,462440,434154.53043937683,0,0,0,0
876,877,200,409.8599853515625,462640,434564.3904247284,0,0,0,0
877,878,280,611.8200073242188,462920,435176.2104320526,0,0,0,0
878,879,180,227.6999969482422,463100,435403.91042900085,0,0,0,0
879,880,300,592.02001953125,463400,435995.9304485321,0,0,0,0
880,881,200,364.32000732421875,463600,436360.2504558563,0,0,0,0
881,882,420,569.25,464020,436929.5004558563,0,0,0,0
882,883,300,500.94000244140625,464320,437430.44045829773,0,0,0,0
883,884,300,387.0899963378906,464620,437817.5304546356,0,0,0,0
884,885,300,751.4099731445312,464920,438568.94042778015,0,0,0,0
885,886,300,204.8300018310547,465220,438773.7704296112,0,0,0,0
886,887,400,1001.6300048828125,465620,439775.400434494,0,0,0,0
887,888,160,409.8599853515625,465780,440185.2604198456,0,0,0,0
888,889,200,182.16000366210938,465980,440367.4204235077,0,0,0,0
889,890,300,318.7799987792969,466280,440686.200422287,0,0,0,0
890,891,300,409.8599853515625,466580,441096.06040763855,0,0,0,0
891,892,200,637.5599975585938,466780,441733.62040519714,0,0,0,0
892,893,460,113.75,467240,441847.37040519714,0,0,0,0
893,894,100,364.1700134277344,467340,442211.5404186249,0,0,0,0
894,895,200,296.010009765625,467540,442507.5504283905,0,0,0,0
895,896,280,409.8599853515625,467820,442917.41041374207,0,0,0,0
896,897,300,273.239990234375,468120,443190.65040397644,0,0,0,0
897,898,200,296.010009765625,468320,443486.66041374207,0,0,0,0
898,899,200,500.94000244140625,468520,443987.6004161835,0,0,0,0
899,900,200,500.8399963378906,468720,444488.44041252136,0,0,0,0
900,901,200,387.0899963378906,468920,444875.53040885925,0,0,0,0
901,902,180,341.54998779296875,469100,445217.0803966522,0,0,0,0
902,903,180,318.7799987792969,469280,445535.8603954315,0,0,0,0
903,904,200,341.54998779296875,469480,445877.4103832245,0,0,0,0
904,905,300,523.7100219726562,469780,446401.12040519714,0,0,0,0
905,906,300,387.0899963378906,470080,446788.21040153503,0,0,0,0
906,907,200,409.760009765625,470280,447197.97041130066,0,0,0,0
907,908,200,273.239990234375,470480,447471.21040153503,0,0,0,0
908,909,8860,13155.7001953125,479340,460626.91059684753,0,0,0,0
909,910,18160,21340.26953125,497500,481967.18012809753,0,0,0,0
910,911,260,227.6999969482422,497760,482194.8801250458,0,0,0,0
911,912,360,317.739990234375,498120,482512.62011528015,0,0,0,0
912,913,180,182.05999755859375,498300,482694.68011283875,0,0,0,0
913,914,300,523.6599731445312,498600,483218.3400859833,0,0,0,0
914,915,260,409.4599914550781,498860,483627.80007743835,0,0,0,0
915,916,200,227.1999969482422,499060,483855.0000743866,0,0,0,0
916,917,240,313.239990234375,499300,484168.240064621,0,0,0,0
917,918,200,250.47000122070312,499500,484418.7100658417,0,0,0,0
918,919,300,432.6300048828125,499800,484851.3400707245,0,0,0,0
919,920,260,273.239990234375,500060,485124.58006095886,0,0,0,0
920,921,160,204.92999267578125,500220,485329.51005363464,0,0,0,0
921,922,240,204.8800048828125,500460,485534.39005851746,0,0,0,0
922,923,300,113.80000305175781,500760,485648.1900615692,0,0,0,0
923,924,300,250.47000122070312,501060,485898.6600627899,0,0,0,0
924,925,200,0.0,501260,485898.6600627899,0,0,0,0
925,926,300,227.6999969482422,501560,486126.36005973816,0,0,0,0
926,927,200,318.7300109863281,501760,486445.0900707245,0,0,0,0
927,928,300,113.8499984741211,502060,486558.9400691986,0,0,0,0
928,929,380,384.5199890136719,502440,486943.4600582123,0,0,0,0
929,930,180,182.16000366210938,502620,487125.6200618744,0,0,0,0
930,931,400,227.6999969482422,503020,487353.32005882263,0,0,0,0
931,932,180,318.7799987792969,503200,487672.1000576019,0,0,0,0
932,933,300,364.2200012207031,503500,488036.32005882263,0,0,0,0
933,934,200,296.010009765625,503700,488332.33006858826,0,0,0,0
934,935,200,182.16000366210938,503900,488514.49007225037,0,0,0,0
935,936,280,0.0,504180,488514.49007225037,0,0,0,0
936,937,240,364.2699890136719,504420,488878.76006126404,0,0,0,0
937,938,300,250.47000122070312,504720,489129.23006248474,0,0,0,0
938,939,360,159.38999938964844,505080,489288.6200618744,0,0,0,0
939,940,300,227.64999389648438,505380,489516.2700557709,0,0,0,0
940,941,280,318.7799987792969,505660,489835.0500545502,0,0,0,0
941,942,300,227.64999389648438,505960,490062.70004844666,0,0,0,0
942,943,200,478.1700134277344,506160,490540.8700618744,0,0,0,0
943,944,200,68.30999755859375,506360,490609.180059433,0,0,0,0
944,945,200,293.239990234375,506560,490902.42004966736,0,0,0,0
945,946,300,387.0899963378906,506860,491289.51004600525,0,0,0,0
946,947,160,250.47000122070312,507020,491539.98004722595,0,0,0,0
947,948,280,318.7799987792969,507300,491858.76004600525,0,0,0,0
948,949,280,156.4199981689453,507580,492015.1800441742,0,0,0,0
949,950,200,204.92999267578125,507780,492220.11003685,0,0,0,0
950,951,380,569.25,508160,492789.36003685,0,0,0,0
951,952,300,478.1700134277344,508460,493267.5300502777,0,0,0,0
952,953,300,296.010009765625,508760,493563.54006004333,0,0,0,0
953,954,360,136.6199951171875,509120,493700.1600551605,0,0,0,0
954,955,200,336.6000061035156,509320,494036.76006126404,0,0,0,0
955,956,300,751.4099731445312,509620,494788.17003440857,0,0,0,0
956,957,400,500.94000244140625,510020,495289.11003685,0,0,0,0
957,958,300,250.47000122070312,510320,495539.5800380707,0,0,0,0
958,959,300,250.47000122070312,510620,495790.0500392914,0,0,0,0
959,960,300,227.6999969482422,510920,496017.7500362396,0,0,0,0
960,961,400,569.25,511320,496587.0000362396,0,0,0,0
961,962,200,0.0,511520,496587.0000362396,0,0,0,0
962,963,300,136.6199951171875,511820,496723.6200313568,0,0,0,0
963,964,280,364.32000732421875,512100,497087.94003868103,0,0,0,0
964,965,400,660.3300170898438,512500,497748.2700557709,0,0,0,0
965,966,500,592.02001953125,513000,498340.2900753021,0,0,0,0
966,967,560,726.6599731445312,513560,499066.95004844666,0,0,0,0
967,968,300,273.239990234375,513860,499340.19003868103,0,0,0,0
968,969,340,0.0,514200,499340.19003868103,0,0,0,0
969,970,400,318.7799987792969,514600,499658.9700374603,0,0,0,0
970,971,300,341.54998779296875,514900,500000.5200252533,0,0,0,0
971,972,400,341.54998779296875,515300,500342.07001304626,0,0,0,0
972,973,280,409.8599853515625,515580,500751.9299983978,0,0,0,0
973,974,400,409.8599853515625,515980,501161.7899837494,0,0,0,0
974,975,160,136.6199951171875,516140,501298.4099788666,0,0,0,0
975,976,300,520.9400024414062,516440,501819.349981308,0,0,0,0
976,977,200,159.38999938964844,516640,501978.73998069763,0,0,0,0
977,978,300,250.47000122070312,516940,502229.20998191833,0,0,0,0
978,979,300,364.32000732421875,517240,502593.52998924255,0,0,0,0
979,980,300,318.7799987792969,517540,502912.30998802185,0,0,0,0
980,981,300,340.55999755859375,517840,503252.86998558044,0,0,0,0
981,982,180,546.47998046875,518020,503799.3499660492,0,0,0,0
982,983,160,250.47000122070312,518180,504049.8199672699,0,0,0,0
983,984,400,455.3999938964844,518580,504505.2199611664,0,0,0,0
984,985,200,136.6199951171875,518780,504641.83995628357,0,0,0,0
985,986,200,227.6999969482422,518980,504869.5399532318,0,0,0,0
986,987,200,159.38999938964844,519180,505028.92995262146,0,0,0,0
987,988,300,273.239990234375,519480,505302.16994285583,0,0,0,0
988,989,300,250.47000122070312,519780,505552.63994407654,0,0,0,0
989,990,400,592.02001953125,520180,506144.6599636078,0,0,0,0
990,991,200,341.54998779296875,520380,506486.20995140076,0,0,0,0
991,992,300,409.8599853515625,520680,506896.0699367523,0,0,0,0
992,993,380,136.6199951171875,521060,507032.6899318695,0,0,0,0
993,994,300,569.0,521360,507601.6899318695,0,0,0,0
994,995,500,0.0,521860,507601.6899318695,0,0,0,0
995,996,180,273.239990234375,522040,507874.9299221039,0,0,0,0
996,997,200,273.239990234375,522240,508148.16991233826,0,0,0,0
997,998,300,500.94000244140625,522540,508649.10991477966,0,0,0,0
998,999,300,250.47000122070312,522840,508899.57991600037,0,0,0,0
999,1000,300,455.3999938964844,523140,509354.97990989685,0,0,0,0
